TILEMAP
480 32 							-- Size of tile map in tiles
8 8 							-- Tile size & block size
images/rtypeColider.png 	-- Tilesheet
1 1 								-- Number of tiles in tilesheet
111111111111111111111111111111111111111111111111111111111111111111111111111111111111111111111111111111111111111111111111111111111111111111111111111111111111111111111111111111111111111111111111111111111111111111111111111111111111111111111111111111111111111111111111111111111111111111111111111111111111111111111111111111111111111111111111111111111111111111111111111111111111111111111111111111111111111111111111111111111111111111111111111111111111111111111111111111111111111111111111
                                                       1   1 1           1                 1     1                     1                       1               1                                 1                 1     1     1                               11                                              1                      1                                                                                                                                                         
                                                        111   1          1                 1111111                     1111111111111111111111111               1                                 1                 1     1     1                              1                                                1                      1                                                                                                                                                         
                                                              1          1                                                  11    111    11                    1                                 1                 1     1     1   1   1   1   1   11        11                                                1                      1                                                                                                                                                         
                                                               1          1                                                                                    1                                  1                1     1      111 111 111 111 111  1       1                                                 1                      1                                                                                                                                                         
                                                                1          1                                                                                   1                                  1                1     1                           1      1                                                  1                      1                                                                                                                                                         
                                                                1          1                                                                                   1         111111111111111111       1                1     1                            1   11                                                   1                      1                                                                                                                                                         
                                                                1         1                                                                                    1        1                  1      1                1111111                             111                                                     1                      1                                                                                                                                                         
                                                                1        1                                                                                     1        1                  1     1                                                                                                             111111111111111111111111                                                                                                                                                         
                                                                1111111111                                                                                     1111111111                  1111111                                                                                                                                                                                                                                                                                              
                                                                                                                                                                                                                                                                                                                                                                                                                                                                                                
                                                                                                                                                                                                                                                                                                                                                                                                                                                                                                
                                                                                                                                                                                                                                                                                                                                                                                                                                                                                                
                                                                                                                                                                                                                                                                                                                                                                                                                                                                                                
                                                                                                                                                                                                                                                                                                                                                                                                                                                                                                
                                                                                                                                                                                                                                                                                                                                                                                                                                                                                                
                                                                                                                                                                                                                                                                                                                                                                                                                                                                                                
                                                                                                                                                                                                                                                                                                                                                                                                                                                                                                
                                                                                                                                                                                                                                                                                                                                                                                                                                                                                                
                                                                                                                                                                                                                                                                                                                                                                                                                                                                                                
                                                                                                                                                                                                                                                                                                                                                                                                                                                                                                
                                                                                                                                                                                                                                                                                                                                                                                                                                                                                                
                                                                1111111111                                                                                                                                                                                                                                                                                                                                                                                                                      
                                                                1        1                                                                                                                                                                                                                                     111111111111111111111111                                                                                                                                                         
                                                                1         1                                                                                                                1111111                 1111111                             111                                                     1                      1                                                                                                                                                         
                                                                1          1                                                                                                               1     1                 1     1                            1   11                                                   1                      1                                                                                                                                                         
                                                                1          1                                                                                                               1     1                 1     1                           1      1                                                  1                      1                                                                                                                                                         
                                                               1          1                      1111111                                                       1111111                     1     1                 1     1      111 111 111 111 111  1       1                                                 1                      1                                                                                                                                                         
                                                              1          1                       1     1                    11    111    11                    1     1                     1     1                 1     1     1   1   1   1   1   11        11                                                1                      1                                                                                                                                                         
                                                        111   1          1                       1     1               1111111111111111111111111               1     1                     1     1                 1     1     1                              1                                                1                      1                                                                                                                                                         
                                                       1   1 1           1                       1     1               1                        11 11     11 111      1111            11 111     1                 1     1     1                               11                                              1                      1                                                                                                                                                         
111111111111111111111111111111111111111111111111111111111111111111111111111111111111111111111111111111111111111111111111111111111111111111111111111111111111111111111111111111111111111111111111111111111111111111111111111111111111111111111111111111111111111111111111111111111111111111111111111111111111111111111111111111111111111111111111111111111111111111111111111111111111111111111111111111111111111111111111111111111111111111111111111111111111111111111111111111111111111111111111